#############
# O         #
# P     #####
#           #
#######     #
# O ##  #####
#   ##  #
#       #####
# XX       ##
#       #   #
#############
