#############
# O         #
# P     #####
#        P  #
#######     #
# O ##  #####
#   ##  #
#       #####
# XX P     ##
#       #   #
#############
