#############
# O     X   #
# P  X  #####
#           #
#######     #
# O ##  #####
#   ##  #
#       #####
# XX X     ##
#       #   #
#############
